111111111111111111111111111111111111
11                                11
11                                11
11             222                11
11                                11
11                                11
11                                11
1111   11111   1   1   111111   1111
11           1 1 1 1 1            11
11                                11
11                                11
11                                11
1111   1111             11111   1111
11                                11
11                                11
11                                11
11                                11
1111   111  22       22  1111   1111
11            22   22             11
11                                11
11                                11
11                                11
1111   2111111      111111112   1111
11                                11
11             333                11
11                                11
11                                11
111111111111111111111111111111111111