111111111111111111111111111111111111
11                                11
11                                11
11      1111         1111         11
11                                11
11                                11
11                                11
1111                            1111
11                                11
11                                11
11                                11
11                                11
11     1111  333   444  11111     11
11                                11
11                                11
11              111               11
11                                11
11     111  22       22  1111     11
11            22   22             11
11             22222              11
11                                11
11                                11
111                               11
11              222               11
11                                11
11                                11
11                                11
111111111111111111111111111111111111